1 0 0 0 4 1 3
3 1 0 0 4 1 3
3 2 0 0 6 1 3
4 3 0 0 6 2 3
5 4 2 0 8 2 4
5 5 2 0 8 2 5
4 5 2 0 8 2 5
3 6 3 1 9 2 5
3 6 3 1 9 2 5
2 6 4 1 9 2 5
2 6 4 1 10 2 5
2 6 5 2 10 2 4
2 6 4 2 12 2 4
2 5 4 2 12 2 3